################
#S___****______#
#____****______#
#__________E___#
#__********____#
#______****____#
#______****____#
#______________#
################