####################################################################################################
#S::  ;:: ;:: ######## ;::  :: ######## :: ;:: ######## ;::  ;;                 ;;;;;;            S#
#::  ;:: ;; ######## ;::  ;; ######## :: ;; ######## ;::  ;;                     ::                #
#:: ;; ;:: ;; :: :;; ;:: ;; :: ;;; ;; :;; ;; ;; ;:: ;; ;; ;; ;;    ;;;;;;;;;;;;;;;;;;;;;;;;;;;;;;;;#
#;; :; ;; ;: ;:: ;; ;:: ;; ;:: ;; ;; ;; ;:: ;; ;;                 ;;;;;;;;;;;;;;;;;;;;;;;;;;;;;;;;;#
#     #################### ;:: ;:: ;: :::: :; :::: ###### ########;;;;;;;;;;;;;;;;;;;;;;;;;;########
#     ######## ;:: ;; ;:: ;; ######## ;: ;; ;; ;;  ; #### ### ;;; ;;;;;;;;;;;;;;;;;;;;;;;;##########
#     ######## ;;; ;; ;; ############## ;:: ;;; ;; ;; ### ######;;;;;;;;;;;;;;;;;;;;;;;;;;##########
#;;;;; ;; ;; ;; ;; ;; ############## ;:: ;; ;; ;;  ; #### ######;;;;;;;;;;;;;;;;;;;;;;;;############
#      ############# ;; ;; ;; ;; :: ############## ;;; ;; ;; ########;;;;;;;;;;;;;;;;;;;############
#      ############# ;;; ;; ;; ;; ############## ;  ;; ;; ########;;;;;;;;;;;;;;;;;;;;##############
#;;;;; ;; ;; ;; ;; ;; ;; ;; ;; ;; ############# ;;                ;;;;;;;;;;;;;;;;;;;;;#############
#    ################## ;; ;; ############# ;; ################ ;; ############# ;; ################
#    ######## ;; ;; ######## ;; ;; ######## ;; ;; ######## ;; ;; ######## ;; ;; ######## ;; ;;     #
#    ######## ;; ;; ######## ;; ;; ######## ;; ;; ######## ;; ;; ######## ;; ;; ######## ;; ;;     #
#;;;;; ;; ;; ;; ;; ;; ;; ;; ;; ;; ;; ;; ;; ;; ;; ;; ;; ;; ;; ;; ;; ;; ;; ;; ;; ;; ;; ;; ;; ;; ;; ;;#
#       ############### ;; ;; ############### ;; ;; ############### ;; ;; ############### ;; ;;    #
#       ############### ;; ;; ############### ;; ;; ############### ;; ;; ############### ;; ;;    #
#;;;;; ;; ;; ;; ;; ;; ;; ;; ;; ;; ;; ;; ;; ;; ;; ;; ;; ;; ;; ;; ;; ;; ;; ;; ;; ;; ;; ;; ;; ;; ;; ;;#
#     #################### ;; ;; ################ ;; ;; ################ ;; ;; ###########       ###
#     ######## ;; ;; ######## ;; ;; ######## ;; ;; ######## ;; ;; ######## ;; ;; #####         #####
#     ######## ;; ;; ############## ;; ;; ############## ;; ;;                                     #
#;;;;; ;; ;; ;; ;; ############## ;; ;; ############## ;; ;;                                       #
#      ############# ;; ;; ############## ;; ;; ############## ;; ;; ########                      #
#      ############# ;; ;; ############## ;; ;; ############## ;; ;; ########                      #
#;;;;; ;; ;; ;; ;; ;; ;; ;; ;; ;; ;; ;; ;; ;; ;; ;; ;; ;; ;; ;; ;; ;; ;; ;; ;; ;; ;; ;; ;;         #
#    ################## ;; ;; ############# ;; ################ ;; ############# ;; ################
#    ######## ;; ;; ######## ;; ;; ######## ;; ;; ######## ;; ;; ######## ;; ;; ######## ;; ;;     #
############# ;; ;; ######## ;; ;; ######## ;; ;; ######## ;; ;; ######## ;; ;; ######## ;; ;;     #
#;;;;; ;; ;; ;; ;; ;; ;; ;; ;; ;; ;; ;; ;; ;; ;; ;; ;; ;; ;; ;; ;; ;; ;; ;; ;; ;; ;; ;; ;; ;; ;;   #
#       ############### ;; ;; ############### ;; ;; ############### ;; ;; ############### ;; ;;    #
#       ############### ;; ;; ############### ;; ;; ############### ;; ;; ############### ;; ;;    #
#;;;;; ;; ;; ;; ;; ;; ;; ;; ;; ;; ;; ;; ;; ;; ;; ;; ;; ;; ;; ;; ;; ;; ;; ;; ;; ;; ;; ;; ;; ;; ;; ;;#
#;;;;;#################### ;; ;; ################ ;; ;; ################ ;; ;;        ##############
#;;;;;######## ;; ;; ######## ;; ;; ######## ;; ;; ######## ;; ;; ######## ;; ;;          ##########
#;;;;;######## ;; ;; ############## ;; ;; ############## ;; ;;                                     #
#;;;;; ;; ;; ;; ;; ############## ;; ;; ############## ;; ;;                                       #
#;;;;;############## ;; ;; ############## ;; ;; ############## ;; ;; ########                      #
#;;;;; ############# ;; ;; ############## ;; ;; ############## ;; ;; ########                      #
#;;;;;:;; ;; ;; ;; ;; ;; ;; ;; ;; ;; ;; ;; ;; ;; ;; ;; ;; ;; ;; ;; ;; ;; ;; ;; ;; ;; ;; ;;         #
#;;;;;################# ;; ;; ############# ;; ################ ;; ############# ;; ################
#;;;;;####### ;; ;; ######## ;; ;; ######## ;; ;; ######## ;; ;; ######## ;; ;; ######## ;; ;;     #
#;;;;;####### ;; ;; ######## ;; ;; ######## ;; ;; ######## ;; ;; ######## ;; ;; ######## ;; ;;     #
#;;;;; ;; ;; ;; ;; ;; ;; ;; ;; ;; ;; ;; ;; ;; ;; ;; ;; ;; ;; ;; ;; ;; ;; ;; ;; ;; ;; ;; ;; ;; ;;   #
#;;;;;  ############### ;; ;; ############### ;; ;; ############### ;; ;; ############### ;; ;;    #
#;;;;;  ############### ;; ;; ############### ;; ;; ############### ;; ;; ############### ;; ;;    #
#;;;;; ;; ;; ;; ;; ;; ;; ;; ;; ;; ;; ;; ;; ;; ;; ;; ;; ;; ;; ;; ;; ;; ;; ;; ;; ;; ;; ;  ;; ;; ;; ;;#
#;;;;;#################### ;; ;; ################ ;; ;; ################ ;; ;;         #############
#;;;;;######## ;; ;; ######## ;; ;; ######## ;; ;; ######## ;; ;; ######## ;; ;; #####         #####
#;;;;;######## ;; ;; ############## ;; ;; ############## ;; ;;                                     #
#;;;;; ;; ;; ;; ;; ############## ;; ;; ############## ;; ;;                                       #
#;;;;; ############# ;; ;; ############## ;; ;; ############## ;; ;; ########                      #
#;;;;; ############# ;; ;; ############## ;; ;; ############## ;; ;; ########                      #
#;;;;; ;; ;; ;; ;; ;; ;; ;; ;; ;; ;; ;; ;; ;; ;; ;; ;; ;; ;; ;; ;; ;; ;; ;; ;; ;; ;  ;; ;;         #
#;;;;;################# ;; ;; ############# ;; ################ ;; ############     ################
#;;;;;####### ;; ;; ######## ;; ;; ######## ;; ;; ######## ;; ;; ######## ;; ;  ######## ;; ;;     #
#;;;;;####### ;; ;; ######## ;; ;; ######## ;; ;; ######## ;; ;; ######## ;; ;; ######## ;; ;;     #
#;;;;; ;; ;; ;; ;; ;; ;; ;; ;; ;; ;; ;; ;; ;; ;; ;; ;; ;; ;; ;; ;; ;; ;; ;; ;; ;; ;; ;; ;; ;; ;;   #
#;;;;;  ############### ;; ;; ############### ;; ;; ############### ;; ;; ############### ;; ;;    #
#;;;;;  ############### ;; ;; ############### ;; ;; ############### ;; ;; ############### ;; ;;    #
#;;;;; ;; ;; ;; ;; ;; ;; ;; ;; ;; ;; ;; ;; ;; ;; ;; ;; ;; ;; ;; ;; ;; ;; ;; ;; ;; ;; ;; ;; ;; ;; ;;#
#;;;;;#################### ;; ;; ################ ;; ;; ################ ;; ;;        ##############
#;;;;;######## ;; ;; ######## ;; ;; ######## ;; ;; ######## ;; ;; ######## ;; ;;          ##########
#;;;;;######## ;; ;; ############## ;; ;; ############## ;; ;;                                     #
#;;;;; ;; ;; ;; ;; ############## ;; ;; ############## ;; ;;                                       #
#;;;;; ############# ;; ;; ############## ;; ;; ############## ;; ;; ########                      #
#;;;;; ############# ;; ;; ############## ;; ;; ############## ;; ;; ########                      #
#;;;;; ;; ;; ;; ;; ;; ;; ;; ;; ;; ;; ;; ;; ;; ;; ;; ;; ;; ;; ;; ;; ;; ;; ;; ;; ;; ;; ;; ;;         #
#                                                             E                                    #
####################################################################################################