####################################################################################################
#S::  ;:: ;:: ######## ;::  :: ######## :: ;:: ######## ;::  ;;                                    #
#::  ;:: ;; ######## ;::  ;; ######## :: ;; ######## ;::  ;;                                       #
#:: ;; ;:: ;; :: :;; ;:: ;; :: ;;; ;; :;; ;; ;; ;:: ;; ;; ;; ;; ;; ;; ;; ;; ;; ;; ;; ;; ;; ;; ;; ;;#
#;; :; ;; ;: ;:: ;; ;:: ;; ;:: ;; ;; ;; ;:: ;; ;; ;; ;; ;:: ;; ;; ;; ;; ;; ;; ;; ;; ;; ;; ;; ;; ;; #
#     #################### ;:: ;:: ;: :::: :; :::: ############### ;;; ;;; ;; ;; ;; ;; ;; ;;########
#     ######## ;:: ;; ;:: ;; ######## ;: ;; ;; ;; ;; ######## ;;; ;;                      ##########
#     ######## ;;; ;; ;; ############## ;:: ;;; ;; ;; ############## ;;; ;;                        #
#;;;;; ;; ;; ;; ;; ;; ############## ;:: ;; ;; ;; ;; ############## ;: ;; ;; ;; ;; ;; ;; ;; ;; ;;  #
#      ############# ;; ;; ;; ;; :: ############## ;;; ;; ;; ######## ;; ;; ;; ;; ;; ;;            #
#      ############# ;;; ;; ;; ;; ############## ;; ;; ;; ######## ;; ;; ;; ;; ;; ;; ;;            #
#;;;;; ;; ;; ;; ;; ;; ;; ;; ;; ;; ############# ;; ;; ;; ;; ;; ;; ;; ;; ;; ;; ;; ;; ;; ;;          #
#    ################## ;; ;; ############# ;; ################ ;; ############# ;; ################
#    ######## ;; ;; ######## ;; ;; ######## ;; ;; ######## ;; ;; ######## ;; ;; ######## ;; ;;     #
#    ######## ;; ;; ######## ;; ;; ######## ;; ;; ######## ;; ;; ######## ;; ;; ######## ;; ;;     #
#;;;;; ;; ;; ;; ;; ;; ;; ;; ;; ;; ;; ;; ;; ;; ;; ;; ;; ;; ;; ;; ;; ;; ;; ;; ;; ;; ;; ;; ;; ;; ;; ;;#
#       ############### ;; ;; ############### ;; ;; ############### ;; ;; ############### ;; ;;    #
#       ############### ;; ;; ############### ;; ;; ############### ;; ;; ############### ;; ;;    #
#;;;;; ;; ;; ;; ;; ;; ;; ;; ;; ;; ;; ;; ;; ;; ;; ;; ;; ;; ;; ;; ;; ;; ;; ;; ;; ;; ;; ;; ;; ;; ;; ;;#
#     #################### ;; ;; ################ ;; ;; ################ ;; ;; ###########       ###
#     ######## ;; ;; ######## ;; ;; ######## ;; ;; ######## ;; ;; ######## ;; ;; #####         #####
#     ######## ;; ;; ############## ;; ;; ############## ;; ;;                                     #
#;;;;; ;; ;; ;; ;; ############## ;; ;; ############## ;; ;;                                       #
#      ############# ;; ;; ############## ;; ;; ############## ;; ;; ########                      #
#      ############# ;; ;; ############## ;; ;; ############## ;; ;; ########                      #
#;;;;; ;; ;; ;; ;; ;; ;; ;; ;; ;; ;; ;; ;; ;; ;; ;; ;; ;; ;; ;; ;; ;; ;; ;; ;; ;; ;; ;; ;;         #
#    ################## ;; ;; ############# ;; ################ ;; ############# ;; ################
#    ######## ;; ;; ######## ;; ;; ######## ;; ;; ######## ;; ;; ######## ;; ;; ######## ;; ;;     #
############# ;; ;; ######## ;; ;; ######## ;; ;; ######## ;; ;; ######## ;; ;; ######## ;; ;;     #
#;;;;; ;; ;; ;; ;; ;; ;; ;; ;; ;; ;; ;; ;; ;; ;; ;; ;; ;; ;; ;; ;; ;; ;; ;; ;; ;; ;; ;; ;; ;; ;;   #
#       ############### ;; ;; ############### ;; ;; ############### ;; ;; ############### ;; ;;    #
#       ############### ;; ;; ############### ;; ;; ############### ;; ;; ############### ;; ;;    #
#;;;;; ;; ;; ;; ;; ;; ;; ;; ;; ;; ;; ;; ;; ;; ;; ;; ;; ;; ;; ;; ;; ;; ;; ;; ;; ;; ;; ;; ;; ;; ;; ;;#
#;;;;;#################### ;; ;; ################ ;; ;; ################ ;; ;;        ##############
#;;;;;######## ;; ;; ######## ;; ;; ######## ;; ;; ######## ;; ;; ######## ;; ;;          ##########
#;;;;;######## ;; ;; ############## ;; ;; ############## ;; ;;                                     #
#;;;;; ;; ;; ;; ;; ############## ;; ;; ############## ;; ;;                                       #
#;;;;;############## ;; ;; ############## ;; ;; ############## ;; ;; ########                      #
#;;;;; ############# ;; ;; ############## ;; ;; ############## ;; ;; ########                      #
#;;;;;:;; ;; ;; ;; ;; ;; ;; ;; ;; ;; ;; ;; ;; ;; ;; ;; ;; ;; ;; ;; ;; ;; ;; ;; ;; ;; ;; ;;         #
#;;;;;################# ;; ;; ############# ;; ################ ;; ############# ;; ################
#;;;;;####### ;; ;; ######## ;; ;; ######## ;; ;; ######## ;; ;; ######## ;; ;; ######## ;; ;;     #
#;;;;;####### ;; ;; ######## ;; ;; ######## ;; ;; ######## ;; ;; ######## ;; ;; ######## ;; ;;     #
#;;;;; ;; ;; ;; ;; ;; ;; ;; ;; ;; ;; ;; ;; ;; ;; ;; ;; ;; ;; ;; ;; ;; ;; ;; ;; ;; ;; ;; ;; ;; ;;   #
#;;;;;  ############### ;; ;; ############### ;; ;; ############### ;; ;; ############### ;; ;;    #
#;;;;;  ############### ;; ;; ############### ;; ;; ############### ;; ;; ############### ;; ;;    #
#;;;;; ;; ;; ;; ;; ;; ;; ;; ;; ;; ;; ;; ;; ;; ;; ;; ;; ;; ;; ;; ;; ;; ;; ;; ;; ;; ;; ;; ;; ;; ;; ;;#
#;;;;;#################### ;; ;; ################ ;; ;; ################ ;; ;;        ##############
#;;;;;######## ;; ;; ######## ;; ;; ######## ;; ;; ######## ;; ;; ######## ;; ;; #####         #####
#;;;;;######## ;; ;; ############## ;; ;; ############## ;; ;;                                     #
#;;;;; ;; ;; ;; ;; ############## ;; ;; ############## ;; ;;                                       #
#;;;;; ############# ;; ;; ############## ;; ;; ############## ;; ;; ########                      #
#;;;;; ############# ;; ;; ############## ;; ;; ############## ;; ;; ########                      #
#;;;;; ;; ;; ;; ;; ;; ;; ;; ;; ;; ;; ;; ;; ;; ;; ;; ;; ;; ;; ;; ;; ;; ;; ;; ;; ;; ;; ;; ;;         #
#;;;;;################# ;; ;; ############# ;; ################ ;; ############# ;; ################
#;;;;;####### ;; ;; ######## ;; ;; ######## ;; ;; ######## ;; ;; ######## ;; ;; ######## ;; ;;     #
#;;;;;####### ;; ;; ######## ;; ;; ######## ;; ;; ######## ;; ;; ######## ;; ;; ######## ;; ;;     #
#;;;;; ;; ;; ;; ;; ;; ;; ;; ;; ;; ;; ;; ;; ;; ;; ;; ;; ;; ;; ;; ;; ;; ;; ;; ;; ;; ;; ;; ;; ;; ;;   #
#;;;;;  ############### ;; ;; ############### ;; ;; ############### ;; ;; ############### ;; ;;    #
#;;;;;  ############### ;; ;; ############### ;; ;; ############### ;; ;; ############### ;; ;;    #
#;;;;; ;; ;; ;; ;; ;; ;; ;; ;; ;; ;; ;; ;; ;; ;; ;; ;; ;; ;; ;; ;; ;; ;; ;; ;; ;; ;; ;; ;; ;; ;; ;;#
#;;;;;#################### ;; ;; ################ ;; ;; ################ ;; ;;        ##############
#;;;;;######## ;; ;; ######## ;; ;; ######## ;; ;; ######## ;; ;; ######## ;; ;;          ##########
#;;;;;######## ;; ;; ############## ;; ;; ############## ;; ;;                                     #
#;;;;; ;; ;; ;; ;; ############## ;; ;; ############## ;; ;;                                       #
#;;;;; ############# ;; ;; ############## ;; ;; ############## ;; ;; ########                      #
#;;;;; ############# ;; ;; ############## ;; ;; ############## ;; ;; ########                      #
#;;;;; ;; ;; ;; ;; ;; ;; ;; ;; ;; ;; ;; ;; ;; ;; ;; ;; ;; ;; ;; ;; ;; ;; ;; ;; ;; ;; ;; ;;         #
#                                                             E                                    #
####################################################################################################