####################
# S                #
#::###             #
#;;;;;########     #
#;;                #
#    ###############
###    ####E       #
#                  #
####################