####################################################################################################
#S::  ;:: ;:: ######## ;::  :: ######## :: ;:: ######## ;::  ;;                                    #
#::  ;:: ;; ######## ;::  ;; ######## :: ;; ######## ;::  ;;                                       #
#:: ;; ;:: ;; :: :;; ;:: ;; :: ;;; ;; :;; ;; ;; ;:: ;; ;; ;; ;; ;; ;; ;; ;; ;; ;; ;; ;; ;; ;; ;; ;;#
#;; :; ;; ;: ;:: ;; ;:: ;; ;:: ;; ;; ;; ;:: ;; ;; ;; ;; ;:: ;; ;; ;; ;; ;; ;; ;; ;; ;; ;; ;; ;; ;; #
#     #################### ;:: ;:: ;: :::: :; :::: ############### ;;; ;;; ;; ;; ;; ;; ;; ;;########
#     ######## ;:: ;; ;:: ;; ######## ;: ;; ;; ;; ;; ######## ;;; ;;                      ##########
#     ######## ;;; ;; ;; ############## ;:: ;;; ;; ;; ############## ;;; ;;                        #
#;; ;; ;; ;; ;; ;; ;; ############## ;:: ;; ;; ;; ;; ############## ;: ;; ;; ;; ;; ;; ;; ;; ;; ;;  #
#      ############# ;; ;; ;; ;; :: ############## ;;; ;; ;; ######## ;; ;; ;; ;; ;; ;;            #
#      ############# ;;; ;; ;; ;; ############## ;; ;; ;; ######## ;; ;; ;; ;; ;; ;; ;;            #
#;; ;; ;; ;; ;; ;; ;; ;; ;; ;; ;; ############# ;; ;; ;; ;; ;; ;; ;; ;; ;; ;; ;; ;; ;; ;;          #
#    ################## ;; ;; ############# ;; ################ ;; ############# ;; ################
#    ######## ;; ;; ######## ;; ;; ######## ;; ;; ######## ;; ;; ######## ;; ;; ######## ;; ;;     #
#    ######## ;; ;; ######## ;; ;; ######## ;; ;; ######## ;; ;; ######## ;; ;; ######## ;; ;;     #
#;; ;; ;; ;; ;; ;; ;; ;; ;; ;; ;; ;; ;; ;; ;; ;; ;; ;; ;; ;; ;; ;; ;; ;; ;; ;; ;; ;; ;; ;; ;; ;; ;;#
#       ############### ;; ;; ############### ;; ;; ############### ;; ;; ############### ;; ;;    #
#       ############### ;; ;; ############### ;; ;; ############### ;; ;; ############### ;; ;;    #
#;; ;; ;; ;; ;; ;; ;; ;; ;; ;; ;; ;; ;; ;; ;; ;; ;; ;; ;; ;; ;; ;; ;; ;; ;; ;; ;; ;; ;; ;; ;; ;; ;;#
#     #################### ;; ;; ################ ;; ;; ################ ;; ;; ###########       ###
#     ######## ;; ;; ######## ;; ;; ######## ;; ;; ######## ;; ;; ######## ;; ;; #####         #####
#     ######## ;; ;; ############## ;; ;; ############## ;; ;;                                     #
#;; ;; ;; ;; ;; ;; ############## ;; ;; ############## ;; ;;                                       #
#      ############# ;; ;; ############## ;; ;; ############## ;; ;; ########                      #
#      ############# ;; ;; ############## ;; ;; ############## ;; ;; ########                      #
#;; ;; ;; ;; ;; ;; ;; ;; ;; ;; ;; ;; ;; ;; ;; ;; ;; ;; ;; ;; ;; ;; ;; ;; ;; ;; ;; ;; ;; ;;         #
#    ################## ;; ;; ############# ;; ################ ;; ############# ;; ################
#    ######## ;; ;; ######## ;; ;; ######## ;; ;; ######## ;; ;; ######## ;; ;; ######## ;; ;;     #
#    ######## ;; ;; ######## ;; ;; ######## ;; ;; ######## ;; ;; ######## ;; ;; ######## ;; ;;     #
#;; ;; ;; ;; ;; ;; ;; ;; ;; ;; ;; ;; ;; ;; ;; ;; ;; ;; ;; ;; ;; ;; ;; ;; ;; ;; ;; ;; ;; ;; ;; ;;   #
#       ############### ;; ;; ############### ;; ;; ############### ;; ;; ############### ;; ;;    #
#       ############### ;; ;; ############### ;; ;; ############### ;; ;; ############### ;; ;;    #
#;; ;; ;; ;; ;; ;; ;; ;; ;; ;; ;; ;; ;; ;; ;; ;; ;; ;; ;; ;; ;; ;; ;; ;; ;; ;; ;; ;; ;; ;; ;; ;; ;;#
#     #################### ;; ;; ################ ;; ;; ################ ;; ;;        ##############
#     ######## ;; ;; ######## ;; ;; ######## ;; ;; ######## ;; ;; ######## ;; ;;          ##########
#     ######## ;; ;; ############## ;; ;; ############## ;; ;;                                     #
#;; ;; ;; ;; ;; ;; ############## ;; ;; ############## ;; ;;                                       #
#      ############# ;; ;; ############## ;; ;; ############## ;; ;; ########                      #
#      ############# ;; ;; ############## ;; ;; ############## ;; ;; ########                      #
#;; ;; ;; ;; ;; ;; ;; ;; ;; ;; ;; ;; ;; ;; ;; ;; ;; ;; ;; ;; ;; ;; ;; ;; ;; ;; ;; ;; ;; ;;         #
#    ################## ;; ;; ############# ;; ################ ;; ############# ;; ################
#    ######## ;; ;; ######## ;; ;; ######## ;; ;; ######## ;; ;; ######## ;; ;; ######## ;; ;;     #
#    ######## ;; ;; ######## ;; ;; ######## ;; ;; ######## ;; ;; ######## ;; ;; ######## ;; ;;     #
#;; ;; ;; ;; ;; ;; ;; ;; ;; ;; ;; ;; ;; ;; ;; ;; ;; ;; ;; ;; ;; ;; ;; ;; ;; ;; ;; ;; ;; ;; ;; ;;   #
#       ############### ;; ;; ############### ;; ;; ############### ;; ;; ############### ;; ;;    #
#       ############### ;; ;; ############### ;; ;; ############### ;; ;; ############### ;; ;;    #
#;; ;; ;; ;; ;; ;; ;; ;; ;; ;; ;; ;; ;; ;; ;; ;; ;; ;; ;; ;; ;; ;; ;; ;; ;; ;; ;; ;; ;; ;; ;; ;; ;;#
#     #################### ;; ;; ################ ;; ;; ################ ;; ;;        ##############
#     ######## ;; ;; ######## ;; ;; ######## ;; ;; ######## ;; ;; ######## ;; ;; #####         #####
#     ######## ;; ;; ############## ;; ;; ############## ;; ;;                                     #
#;; ;; ;; ;; ;; ;; ############## ;; ;; ############## ;; ;;                                       #
#      ############# ;; ;; ############## ;; ;; ############## ;; ;; ########                      #
#      ############# ;; ;; ############## ;; ;; ############## ;; ;; ########                      #
#;; ;; ;; ;; ;; ;; ;; ;; ;; ;; ;; ;; ;; ;; ;; ;; ;; ;; ;; ;; ;; ;; ;; ;; ;; ;; ;; ;; ;; ;;         #
#    ################## ;; ;; ############# ;; ################ ;; ############# ;; ################
#    ######## ;; ;; ######## ;; ;; ######## ;; ;; ######## ;; ;; ######## ;; ;; ######## ;; ;;     #
#    ######## ;; ;; ######## ;; ;; ######## ;; ;; ######## ;; ;; ######## ;; ;; ######## ;; ;;     #
#;; ;; ;; ;; ;; ;; ;; ;; ;; ;; ;; ;; ;; ;; ;; ;; ;; ;; ;; ;; ;; ;; ;; ;; ;; ;; ;; ;; ;; ;; ;; ;;   #
#       ############### ;; ;; ############### ;; ;; ############### ;; ;; ############### ;; ;;    #
#       ############### ;; ;; ############### ;; ;; ############### ;; ;; ############### ;; ;;    #
#;; ;; ;; ;; ;; ;; ;; ;; ;; ;; ;; ;; ;; ;; ;; ;; ;; ;; ;; ;; ;; ;; ;; ;; ;; ;; ;; ;; ;; ;; ;; ;; ;;#
#     #################### ;; ;; ################ ;; ;; ################ ;; ;;        ##############
#     ######## ;; ;; ######## ;; ;; ######## ;; ;; ######## ;; ;; ######## ;; ;;          ##########
#     ######## ;; ;; ############## ;; ;; ############## ;; ;;                                     #
#;; ;; ;; ;; ;; ;; ############## ;; ;; ############## ;; ;;                                       #
#      ############# ;; ;; ############## ;; ;; ############## ;; ;; ########                      #
#      ############# ;; ;; ############## ;; ;; ############## ;; ;; ########                      #
#;; ;; ;; ;; ;; ;; ;; ;; ;; ;; ;; ;; ;; ;; ;; ;; ;; ;; ;; ;; ;; ;; ;; ;; ;; ;; ;; ;; ;; ;;         #
#                                                             E                                    #
####################################################################################################