############################################################
#S   :;;     ########   ::       ########   ;;;     ########
#   ::;;     ########   ;;       ########   ::      ########
#  :;;  ::                                                 #
#     ####################   ;;;                  ##########
#     ########      ::           ########   :;;            #
#     ########   ;;       ##############   ;;;             #
#             :;;  ##############     ::                   #
#      #############  ::                 ########      ::::#
#      #############   ;;                ########      ;;;;#
#             ;;;   #############      ::                  #
#    ##################   #############   ################ #
#    ########   ::            ########   ;;        #########
#    ########   ;;            ########   ::        #########
#             :;;             ########                     #
#       ###############   ::       ###############         #
#       ###############   ;;       ###############      ####
#                                                          #
#     ####################   :;                  ###########
#     ########   ;;                     ########   :;      #
#     ########  ::       ##############      ;;;           #
#              ;;;  ##############         ::              #
#      #############  ::                ########      ######
#      #############   ;;               ########   E  ######
############################################################