#####################################################################################
####### ;::  :: ######## :: ;:: ######## ;::  ;;                 ;;;;;;            S#
##### ;::  ;; ######## :: ;; ######## ;::  ;;                     ::                #
# :;; ;:: ;; :: ;;; ;; :;; ;; ;; ;:: ;; ;; ;; ;;    ;;;;;;;;;;;;;;;;;;;;;;;;;;;;;;;;#
# ;; ;:: ;; ;:: ;; ;; ;; ;:: ;; ;;                 ;;;;;;;;;;;;;;;;;;;;;;;;;;;;;;;;;#
########### ;:: ;:: ;: :::: :; :::: ###### ########;;;;;;;;;;;;;;;;;;;;;;;;;;########
#:: ;; ;:: ;; ######## ;: ;; ;; ;;  ; #### ### ;;; ;;;;;;;;;;;;;;;;;;;;;;;;##########
#;; ;; ;; ############## ;:: ;;; ;; ;; ### ######;;;;;;;;;;;;;;;;;;;;;;;;;;##########
#;; ;; ############## ;:: ;; ;; ;;  ; #### ######;;;;;;;;;;;;;;;;;;;;;;;;############
##### ;; ;; ;; ;; :: ############## ;;; ;; ;; ########;;;;;;;;;;;;;;;;;;;############
##### ;;; ;; ;; ;; ############## ;  ;; ;; ########;;;;;;;;;;;;;;;;;;;;##############
#;; ;; ;; ;; ;; ;; ############# ;;                ;;;;;;;;;;;;;;;;;;;;;#############
######## ;; ;; ############# ;; ################ ;; ############# ;; ################
# ;; ######## ;; ;; ######## ;; ;; ######## ;; ;; ######## ;; ;; ######## ;; ;;     #
# ;; ######## ;; ;; ######## ;; ;; ######## ;; ;; ######## ;; ;; ######## ;; ;;     #
#;; ;; ;; ;; ;; ;; ;; ;; ;; ;; ;; ;; ;; ;; ;; ;; ;; ;; ;; ;; ;; ;; ;; ;; ;; ;; ;; ;;#
######## ;; ;; ############### ;; ;; ############### ;; ;; ############### ;; ;;    #
######## ;; ;; ############### ;; ;; ############### ;; ;; ############### ;; ;;    #
#;; ;; ;; ;; ;; ;; ;; ;; ;; ;; ;; ;; ;; ;; ;; ;; ;; ;; ;; ;; ;; ;; ;; ;; ;; ;; ;; ;;#
########### ;; ;; ################ ;; ;; ################ ;; ;; ###########       ###
#; ;; ######## ;; ;; ######## ;; ;; ######## ;; ;; ######## ;; ;; #####         #####
#; ;; ############## ;; ;; ############## ;; ;;                                     #
#;; ############## ;; ;; ############## ;; ;;                                       #
##### ;; ;; ############## ;; ;; ############## ;; ;; ########                      #
##### ;; ;; ############## ;; ;; ############## ;; ;; ########                      #
#;; ;; ;; ;; ;; ;; ;; ;; ;; ;; ;; ;; ;; ;; ;; ;; ;; ;; ;; ;; ;; ;; ;; ;; ;;         #
######## ;; ;; ############# ;; ################ ;; ############# ;; ################
# ;; ######## ;; ;; ######## ;; ;; ######## ;; ;; ######## ;; ;; ######## ;; ;;     #
# ;; ######## ;; ;; ######## ;; ;; ######## ;; ;; ######## ;; ;; ######## ;; ;;     #
#;; ;; ;; ;; ;; ;; ;; ;; ;; ;; ;; ;; ;; ;; ;; ;; ;; ;; ;; ;; ;; ;; ;; ;; ;; ;; ;;   #
######## ;; ;; ############### ;; ;; ############### ;; ;; ############### ;; ;;    #
######## ;; ;; ############### ;; ;; ############### ;; ;; ############### ;; ;;    #
#;; ;; ;; ;; ;; ;; ;; ;; ;; ;; ;; ;; ;; ;; ;; ;; ;; ;; ;; ;; ;; ;; ;; ;; ;; ;; ;; ;;#
########### ;; ;; ################ ;; ;; ################ ;; ;;        ##############
#; ;; ######## ;; ;; ######## ;; ;; ######## ;; ;; ######## ;; ;;          ##########
#; ;; ############## ;; ;; ############## ;; ;;                                     #
#;; ############## ;; ;; ############## ;; ;;                                       #
##### ;; ;; ############## ;; ;; ############## ;; ;; ########                      #
##### ;; ;; ############## ;; ;; ############## ;; ;; ########                      #
#;; ;; ;; ;; ;; ;; ;; ;; ;; ;; ;; ;; ;; ;; ;; ;; ;; ;; ;; ;; ;; ;; ;; ;; ;;         #
######## ;; ;; ############# ;; ################ ;; ############# ;; ################
# ;; ######## ;; ;; ######## ;; ;; ######## ;; ;; ######## ;; ;; ######## ;; ;;     #
# ;; ######## ;; ;; ######## ;; ;; ######## ;; ;; ######## ;; ;; ######## ;; ;;     #
#;; ;; ;; ;; ;; ;; ;; ;; ;; ;; ;; ;; ;; ;; ;; ;; ;; ;; ;; ;; ;; ;; ;; ;; ;; ;; ;;   #
######## ;; ;; ############### ;; ;; ############### ;; ;; ############### ;; ;;    #
######## ;; ;; ############### ;; ;; ############### ;; ;; ############### ;; ;;    #
#;; ;; ;; ;; ;; ;; ;; ;; ;; ;; ;; ;; ;; ;; ;; ;; ;; ;; ;; ;; ;; ;; ;; ;  ;; ;; ;; ;;#
########### ;; ;; ################ ;; ;; ################ ;; ;;         #############
#; ;; ######## ;; ;; ######## ;; ;; ######## ;; ;; ######## ;; ;; #####         #####
#; ;; ############## ;; ;; ############## ;; ;;                                     #
#;; ############## ;; ;; ############## ;; ;;                                       #
##### ;; ;; ############## ;; ;; ############## ;; ;; ########                      #
##### ;; ;; ############## ;; ;; ############## ;; ;; ########                      #
#;; ;; ;; ;; ;; ;; ;; ;; ;; ;; ;; ;; ;; ;; ;; ;; ;; ;; ;; ;; ;; ;; ;  ;; ;;         #
######## ;; ;; ############# ;; ################ ;; ############     ################
# ;; ######## ;; ;; ######## ;; ;; ######## ;; ;; ######## ;; ;  ######## ;; ;;     #
# ;; ######## ;; ;; ######## ;; ;; ######## ;; ;; ######## ;; ;; ######## ;; ;;     #
#;; ;; ;; ;; ;; ;; ;; ;; ;; ;; ;; ;; ;; ;; ;; ;; ;; ;; ;; ;; ;; ;; ;; ;; ;; ;; ;;   #
######## ;; ;; ############### ;; ;; ############### ;; ;; ############### ;; ;;    #
######## ;; ;; ############### ;; ;; ############### ;; ;; ############### ;; ;;    #
#;; ;; ;; ;; ;; ;; ;; ;; ;; ;; ;; ;; ;; ;; ;; ;; ;; ;; ;; ;; ;; ;; ;; ;; ;; ;; ;; ;;#
########### ;; ;; ################ ;; ;; ################ ;; ;;        ##############
#; ;; ######## ;; ;; ######## ;; ;; ######## ;; ;; ######## ;; ;;          ##########
#; ;; ############## ;; ;; ############## ;; ;;                                     #
#;; ############## ;; ;; ############## ;; ;;                                       #
##### ;; ;; ############## ;; ;; ############## ;; ;; ########                      #
##### ;; ;; ############## ;; ;; ############## ;; ;; ########                      #
#;; ;; ;; ;; ;; ;; ;; ;; ;; ;; ;; ;; ;; ;; ;; ;; ;; ;; ;; ;; ;; ;; ;; ;; ;;         #
#                                              E                                    #
#####################################################################################