####################
#_S________________#
#__***_____________#
#_____********_____#
#__________________#
#____**************#
#**____****E_______#
#__________________#
####################