#####################################################################################
#####            ########            ########            ########                 S #
#####            ########            ########            ########                   #
#                                                                                   #
###########                        ###############                     ##############
#                                  ########                                ##########
#            ##############                        ##############                   #
#            ##############                        ##############                   #
#########                            ##############                     ########    #
#########                            ##############                     ########    #
#                                                                                   #
########    #############    ################    #############    ###################
#           ########          ########            ########          ########        #
#           ########          ########            ########          ########        #
#                                                                                   #
############           ###############           ###############                    #
############           ###############           ###############                    #
#                                                                                   #
###########                        ################                    ##############
#                                  ########                                ##########
#            ##############                        ##############                   #
#            ##############                        ##############                   #
#########                            ##############                     ########    #
#########                            ##############                     ########    #
#                                                                                   #
########    #############    ################    #############    ###################
#           ########          ########            ########          ########        #
#           ########          ########            ########          ########        #
#                                                                                   #
############           ###############           ###############                    #
############           ###############           ###############                    #
#                                                                                   #
###########                        ################                    ##############
#                                  ########                                ##########
#            ##############                        ##############                   #
#            ##############                        ##############                   #
#########                            ##############                     ########    #
#########                            ##############                     ########    #
#                                                                                   #
########    #############    ################    #############    ###################
#           ########          ########            ########          ########        #
#           ########          ########            ########          ########        #
#                                                                                   #
############           ###############           ###############                    #
############           ###############           ###############                    #
#                                                                                   #
###########                        ################                    ##############
#                                  ########                                ##########
#            ##############                        ##############                   #
#            ##############                        ##############                   #
#########                            ##############                     ########    #
#########                            ##############                     ########    #
#                                                                                   #
########    #############    ################    #############    ###################
#           ########          ########            ########          ########        #
#           ########          ########            ########          ########        #
#                                                                                   #
############           ###############           ###############                    #
############           ###############           ###############                    #
#                                                                                   #
###########                        ################                    ##############
#                                  ########                                ##########
#            ##############                        ##############                   #
#            ##############                        ##############                   #
#########                            ##############                     ########    #
#########                            ##############                     ########    #
#                                                                                   #
########    #############    ################    #############    ###################
#           ########          ########            ########          ########        #
#           ########          ########            ########          ########        #
#                                                                                   #
############           ###############           ###############                    #
############           ###############           ###############                    #
#                                                                                   #
###########                        ################                    ##############
#                                  ########                                ##########
#            ##############                        ##############                   #
#            ##############                        ##############                   #
#########                            ##############                     ########    #
#########                            ##############                     ########    #
#                                                                                   #
#                                              E                                    #
#####################################################################################