####################################################################################################
#S          ########            ########            ########            ########                   #
#           ########            ########            ########            ########                   #
#                                                                                                  #
#     ####################                        ###############                     ##############
#     ########                                    ########                                ##########
#     ########              ##############                        ##############                   #
#                           ##############                        ##############                   #
#          #############                            ##############                     ########    #
#          #############                            ##############                     ########    #
#                                                                                                  #
#    ##################    #############    ################    #############    ###################
#    ########              ########          ########            ########          ########        #
#    ########              ########          ########            ########          ########        #
#                                                                                                  #
#           ###############           ###############           ###############                    #
#           ###############           ###############           ###############                    #
#                                                                                                  #
#     ####################                        ################                    ##############
#     ########                                    ########                                ##########
#     ########              ##############                        ##############                   #
#                           ##############                        ##############                   #
#          #############                            ##############                     ########    #
#          #############                            ##############                     ########    #
#                                                                                                  #
#    ##################    #############    ################    #############    ###################
#    ########              ########          ########            ########          ########        #
#    ########              ########          ########            ########          ########        #
#                                                                                                  #
#           ###############           ###############           ###############                    #
#           ###############           ###############           ###############                    #
#                                                                                                  #
#     ####################                        ################                    ##############
#     ########                                    ########                                ##########
#     ########              ##############                        ##############                   #
#                           ##############                        ##############                   #
#          #############                            ##############                     ########    #
#          #############                            ##############                     ########    #
#                                                                                                  #
#    ##################    #############    ################    #############    ###################
#    ########              ########          ########            ########          ########        #
#    ########              ########          ########            ########          ########        #
#                                                                                                  #
#           ###############           ###############           ###############                    #
#           ###############           ###############           ###############                    #
#                                                                                                  #
#     ####################                        ################                    ##############
#     ########                                    ########                                ##########
#     ########              ##############                        ##############                   #
#                           ##############                        ##############                   #
#          #############                            ##############                     ########    #
#          #############                            ##############                     ########    #
#                                                                                                  #
#    ##################    #############    ################    #############    ###################
#    ########              ########          ########            ########          ########        #
#    ########              ########          ########            ########          ########        #
#                                                                                                  #
#           ###############           ###############           ###############                    #
#           ###############           ###############           ###############                    #
#                                                                                                  #
#     ####################                        ################                    ##############
#     ########                                    ########                                ##########
#     ########              ##############                        ##############                   #
#                           ##############                        ##############                   #
#          #############                            ##############                     ########    #
#          #############                            ##############                     ########    #
#                                                                                                  #
#    ##################    #############    ################    #############    ###################
#    ########              ########          ########            ########          ########        #
#    ########              ########          ########            ########          ########        #
#                                                                                                  #
#           ###############           ###############           ###############                    #
#           ###############           ###############           ###############                    #
#                                                                                                  #
#     ####################                        ################                    ##############
#     ########                                    ########                                ##########
#     ########              ##############                        ##############                   #
#                           ##############                        ##############                   #
#          #############                            ##############                     ########    #
#          #############                            ##############                     ########    #
#                                                                                                  #
#                                                             E                                    #
####################################################################################################