############################################################
#S          ########           ########           ######## #
#           ########           ########           ######## #
#                                                          #
#     ####################                  ################
#     ########                                ########     #
#     ########              ##############                 #
#                           ##############                 #
#          #############                     ########      #
#          #############                     ########      #
#                          #############                   #
#    ##################    #############    ################
#    ########              ########          ########      #
#    ########              ########          ########      #
#                          ########                        #
#           ###############           ###############      #
#           ###############           ###############      #
#                                                          #
#     ####################                  ################
#     ########                                ########     #
#     ########              ##############                 #
#                           ##############                 #
#          #############                     ########      #
#          #############                     ########   E  #
############################################################