###############
#S    ####    #
#     ####    #
#    ;;;;; E ##
#   ######    #
#           ###
###############