###############
#S____****____#
#_____****____#
#__________E_*#
#___******____#
#___________**#
###############