######################
#S      ######       #
#       ######       #
#                    #
#    ############    #
#    ####            #
#           ####     #
#           ####  E  #
#                    #
######################