######################
#S______******_______#
#_______******_______#
#____________________#
#____************____#
#____****____________#
#___________****_____#
#___________****__E__#
#____________________#
######################