############
#S    #### #
#     #### #
#          #
#;:######  #
#;:#       #
#;:#  #### #
#;:#  #### #
#;:#       #
#;:######E #
#          #
############