############
#S    #### #
#     #### #
#       ;;;#
#;:###### ;#
#;:#      ;#
#;:#  #### #
#;:#  #### #
#;:#     ;;#
#;:#    #E #
#    ;;    #
############