############
#S____****_#
#_____****_#
#__________#
#__******__#
#__*_______#
#__*__****_#
#__*__****_#
#__*_______#
#__******E_#
#__________#
############