############
#S    #### #
#     #### #
#          #
#  ######  #
#  #       #
#  #  #### #
#  #  #### #
#  #       #
#  ######E #
#          #
############