##################
#S_____******____#
#______****______#
#________________#
#____********____#
#___________E____#
#________________#
##################