##################
#S     ######    #
#      ####      #
#                #
#    ########    #
#           E    #
#                #
##################