#########################
#S______****____________#
#_______****____________#
#_______________________#
#_____*************_____#
#_____****______________#
#______________****_____#
#______________****__E__#
#########################