#########################
#S      ####            #
#       ####            #
#                       #
#     #############     #
#     ####              #
#              ####     #
#              ####  E  #
#########################