##############
#S_____*****_#
#______*****_#
#____________#
#___*******__#
#___*________#
#___*___****_#
#___*___****_#
#_______E____#
##############