##############
#S     ##### #
#      ##### #
#            #
#   #######  #
#   #        #
#   #   #### #
#   #   #### #
#       E    #
##############