##########
#S  ###  #
#  ###   #
#        #
#  ####  #
#     E  #
#        #
##########