##########
#S__***__#
#__***___#
#________#
#__****__#
#_____E__#
#________#
##########