##########
#S  ###  #
#::###   #
#;:      #
#; ####  #
#;;;;;E  #
#        #
##########