####################
#S____****_________#
#_____****_________#
#__________****____#
#__******__****____#
#__*__________*____#
#__*__*********____#
#__*__________E____#
#__******__________#
#__________________#
####################