####################
#S    ####         #
#     ####         #
#          ####    #
#  ######  ####    #
#::#          #    #
#::#  #########    #
#  #          E    #
#  ######          #
#                  #
####################